||.../...\
\\-.......
-....|-...
........|.
|-....-...
