#######
#....E#
###.#.#
#...#.#
#.#.#.#
#.....#
#.###.#
#S..#.#
#######
