###############
#.........#..E#
#####.###...#.#
#.....#...###.#
#.###.#.#.#.#.#
#S..#.........#
###############
